一	one
二	two
三	three
四	four
五	five
六	six
七	seven
八	eight
九	nine (*baseball)
十	ten
口	mouth
日	day
月	month
田	rice field
目	eye
古	old
吾	I
冒	risk
朋	companion
明	bright
唱	chant
晶	sparkle
品	goods
呂	spine
昌	prosperous
早	early
旭	rising sun
世	generation
胃	stomach
旦	nightbreak
胆	gall bladder
亘	span
凹	concave
凸	convex
旧	olden days
自	oneself
白	white
百	hundred
中	in
千	thousand
舌	tongue
升	measuring box
昇	rise up
丸	round
寸	measurement
専	specialty
博	Dr.
占	fortune telling
上	above
下	below
卓	eminent
朝	morning
只	only
貝	shellfish
貞	upright
員	employee
見	see
児	newborn babe
元	beginning
頁	page (*head)
頑	stubborn
凡	mediocre
負	defeat
万	ten thousand
句	phrase
肌	texture
旬	decameron
勺	ladle
的	bull's eye
首	neck
乙	fishguts
乱	riot
直	straightaway
具	tool
真	true
工	craft
左	left
右	right
有	possess
賄	bribe
貢	tribute
項	paragraph
刀	sword
刃	blade
切	cut
召	seduce
昭	shining
則	rule
副	vice
別	separate
丁	street (+*nail or spike)
町	village
可	can
頂	place on the head
子	child
孔	cavity
了	complete
女	woman
好	fond
如	likeness
母	mama / mother
貫	pierce
兄	elder brother (*teenager)
克	overcome
小	little
少	few
大	large (St. Bernard dog)
多	many
夕	evening
汐	eventide
外	outside
名	name
石	stone (*stone/rocks)
肖	resemblance (*spark or candle)
硝	nitrate
砕	smash
砂	sand
削	plane
光	ray
太	plump
器	utensil
臭	stinking
妙	exquisite
省	focus
厚	thick
奇	strange
川	stream (+flood)
州	state
順	obey
水	water
氷	icicle
永	eternity
泉	spring
原	meadow
願	petition
泳	swim
沼	marsh
沖	open sea
江	creek
汁	soup
潮	tide
源	source
活	lively
消	extinguish
況	but of course
河	river
泊	overnight
湖	lake
測	fathom
土	soil (+*dirt, ground, land)
吐	spit
圧	pressure
埼	cape
垣	hedge
圭	squared jewel (*ivy)
封	seal
涯	horizon
寺	Buddhist temple
時	time
均	level
火	fire (*fireplace/hearth/conflagration) 
炎	inflammation
煩	anxiety
淡	thin
灯	lamp
畑	farm
災	disaster
灰	ashes
点	spot
照	illuminate
魚	fish
漁	fishing
里	ri (*computer)
黒	black
墨	black ink
鯉	carp
量	quantity
厘	rin
埋	bury
同	same (+*monks dressed in a common habit)
洞	den
胴	trunk
向	yonder
尚	esteem
字	character
守	guard
完	perfect
宣	proclaim
宵	wee hours
安	relax
宴	banquet
寄	draw near
富	wealth
貯	savings
木	tree (*wood, in diff shape: also pole/wooden pole)
林	grove
森	forest
桂	Japanese Judas-tree
柏	oak
枠	frame
梢	treetops
棚	shelf
杏	apricot
桐	paulownia
植	plant
枯	wither
朴	crude
村	town
相	inter-
机	desk
本	book
札	tag
暦	calendar
案	plan
燥	parch
未	not yet
末	extremity
沫	splash
味	flavor
妹	younger sister
朱	vermilion
株	stocks
若	young
草	grass
苦	suffering
寛	tolerant
薄	dilute
葉	leaf
模	imitation
漠	vague
墓	grave
暮	livelihood
膜	membrane
苗	seedling
兆	portent (*full form=portent, left half=turtle)
桃	peach tree
眺	stare
犬	dog (*chihuahua, small dog. In other form: pack of wild dogs)
状	status quo
黙	silence
然	sort of thing
荻	reed
狩	hunt
猫	cat
牛	cow
特	special
告	revelation
先	before
洗	wash
介	jammed in
界	world
茶	tea
合	fit
塔	pagoda
王	king (king/scepter)
玉	jewel (*jewel/ball, lacks dot when on left in a kanji)
宝	treasure
珠	pearl
現	present
狂	lunatic
皇	emperor
呈	display
全	whole
栓	plug
理	logic
主	lord (*candlestick)
注	pour
柱	pillar
金	gold (+metal)
銑	pig iron
鉢	bowl
銅	copper
釣	angling
針	needle
銘	Inscription
鎮	tranquilize　
道	road-way
珍	guidance
辻	crossing
迅	swift
造	create
迫	urge
逃	escape
辺	environs
巡	patrol
車	car
連	take along (ie: bring someone along)
軌	rut
輸	transport
前	in front
各	each 
格	status
略	abbreviation
客	guest
額	forehead
夏	summer
処	dispose
条	twig (article, clause, item)
落	fall
冗	superfluous
軍	army
輝	radiance
運	carry
冠	crown
夢	dream
坑	pit (deep pit etc.)
高	tall
享	receive
塾	cram school
熟	mellow
亭	pavilion
京	capital (capital city)
涼	refreshing
景	scenery
鯨	whale
舎	cottage
周	circumference (+*lap)
週	week
士	gentleman (*samurai)
吉	good luck (*aerosol can)
壮	robust
荘	villa
売	sell
学	study
覚	memorize
栄	flourish
書	write
津	haven
牧	breed
攻	aggression
敗	failure
枚	a sheet of
故	happenstance
敬	awe
言	say (*saying, speech, words)
警	admonish
計	plot
獄	prison
訂	revise
討	chastise
訓	instruction
詔	imperial edict
詰	packed
話	tale
詠	recitation
詩	poem
語	word
読	read
調	tune
談	discuss
諾	consent
諭	rebuke
式	style
試	test
弐	two
域	range
賊	burglar
栽	plantation
載	load (ride in edict)
茂	overgrown
成	turn into
城	castle
誠	sincerity
威	intimidate
滅	destroy
減	dwindle
桟	scaffold
銭	coin
浅	shallow
止	stop (*footprint)
歩	walk
渉	ford
頻	repeatedly
肯	agreement
企	undertake
歴	curriculum
武	warrior
賦	levy
正	correct
証	evidence
政	politics
定	determine
錠	lock
走	run
超	transcend
赴	proceed
越	surpass
是	just so
題	topic
堤	dike
建	build
延	prolong
誕	nativity
礎	cornerstone
婿	bridegroom
衣	garment
裁	tailor
装	attire
裏	back
壊	demolition
哀	pathetic
遠	distant
猿	monkey
初	first time
布	linen
帆	sail
幅	hanging scroll
帽	cap
幕	curtain
幌	canopy
錦	brocade
市	market
姉	elder sister
肺	lungs
帯	sash
滞	stagnate
刺	thorn
制	system
製	made in ...
転	revolve
芸	technique
雨	rain (*+weather)
雲	cloud
曇	cloudy weather
雷	thunder
霜	frost
冬	winter
天	heavens (+*heaven)
橋	bridge
嬌	attractive
立	stand up (+*vase)
泣	cry
章	badge　
競	vie
帝	sovereign
童	juvenile
瞳	pupil
鐘	bell
商	make a deal
嫡	legitimate wife
適	suitable
滴	drip
敵	enemy
匕	spoon (+*someone sitting on ground)
北	north
背	stature
比	compare
昆	descendants
皆	all
混	mix
渇	thirst
謁	audience
褐	brown
喝	hoarse
旨	delicious
脂	fat
壱	I (one)
毎	every
敏	cleverness
梅	plum
海	sea
乞	beg
乾	drought
腹	abdomen
複	duplicate
欠	lack (*yawn or lack)
吹	blow　
炊	cook
歌	song
軟	soft
次	next (*second)
茨	briar
資	assets
姿	figure
諮	consult with
賠	compensation
培	cultivate
剖	divide
音	sound
暗	darkness
韻	rhyme
識	discriminating (right primitive is kazoo)
鏡	mirror
境	boundary
亡	perish (+*deceased)
盲	blind
妄	delusion
荒	laid waste
望	ambition
方	direction (*compass)
妨	disturb
坊	boy
芳	perfumed
肪	obese
訪	call on
放	set free
激	violent
脱	undress
説	rumor
鋭	pointed
曽	formerly (*increase)
増	increase
贈	presents
東	east (*direction and political east)
棟	ridgepool
凍	frozen
妊	pregnancy
廷	courts
染	dye
燃	burn
賓	V.I.P.
歳	year-end　
県	prefecture
栃	horse chestnut
地	ground
池	pond
虫	insect (*refers to whole insect kingdom)
蛍	lighting bug
蛇	snake
虹	rainbow
蝶	butterfly
独	single
蚕	silkworm
風	wind
己	self (*snake)
起	rouse
妃	queen
改	reformation
記	scribe
包	wrap
胞	placenta
砲	cannon
泡	bubble
亀	tortoise (*eel)
電	electricity
竜	dragon
滝	waterfall
豚	pork
逐	pursue
遂	consummate
家	house
嫁	marry in
豪	overpowering
腸	intestines
場	location
湯	hot water
羊	sheep
美	beauty
洋	ocean
詳	detailed
鮮	fresh
達	accomplished
羨	envious
差	distinction
着	don
唯	solely
焦	char
礁	reef
集	gather
准	quasi-
進	advance
雑	miscellaneous
雌	feminine
準	semi-
奮	stirred up
奪	rob
確	assurance
午	noon (*horse)
許	permit
歓	delight
権	authority
観	outlook
羽	feathers (+*wings)
習	learn
翌	the following
曜	weekday
濯	laundry
曰	sayeth
困	quandary
固	harden
国	country
団	group
因	cause
姻	matrimony
園	park
回	-times
壇	 podium
店	store
庫	storehouse (warehouse)
庭	courtyard
庁	government office
床	bed
麻	hemp
磨	grind
心	heart　(*to the left - emotional state of mind, *beneath or right=heart, *bottom - valentine)
忘	forget
忍	endure (long-suffering patience)
認	acknowledge
忌	mourning
志	intention
誌	document
忠	loyalty
串	shish kebab
患	afflicted
思	think
恩	grace (favor freely bestowed)
応	apply (fills a certain need)
意	idea
想	concept
息	breath
憩	recess
恵	favor
恐	fear
惑	beguile
感	emotion
憂	melancholy
寡	widow
忙	busy
悦	ecstasy
恒	constancy
悼	lament
悟	enlightenment
怖	dreadful
慌	disconcerted
悔	repent
憎	hate
慣	accustomed
愉	pleasure
惰	lazy
慎	humility
憾	remorse
憶	recollection
慕	pining
添	annexed
必	invariably
泌	ooze
手	hand
看	watch over
摩	chafe
我	ego
義	righteousness
議	deliberation
犠	sacrifice
抹	rub
抱	embrace
搭	board
抄	extract
抗	confront
批	criticism
招	beckon
拓	clear the land
拍	clap
打	strike
拘	arrest
捨	discard
拐	kidnap
摘	pinch
挑	challenge
指	finger
持	hold
括	fasten
揮	brandish
推	conjecture
揚	hoist
提	propose
損	damage
拾	pick up
担	shouldering (shouldering a burden of some sort)
拠	foothold
描	sketch
操	maneuver
接	touch
掲	put up a notice
掛	hang
研	polish
戒	commandment
械	contraption
鼻	nose
刑	punish
型	mould
才	genius (*genie,  other form-> genie in the bottle)
財	property
材	lumber
存	suppose
在	exist
乃	from (*fist) (note: literally is の)
携	portable
及	reach out (*outstretched hands)
吸	suck
扱	handle
丈	length (*tucked under the arm)
史	history
吏	officer
更	grow late
硬	stiff
又	or again (* crotch)
双	pair
桑	mulberry
隻	vessels
護	safeguard
獲	seize
奴	guy
怒	angry
友	friend
抜	slip out
投	throw
没	drown
設	establishment
撃	beat
殻	husk
支	branch
技	skill
枝	bough
肢	limb
茎	stalk (stem)
怪	suspicious
軽	lightly
叔	uncle
督	coach
寂	loneliness
淑	graceful
反	anti-
坂	slope
板	board
返	return
販	marketing
爪	claw (*vulture)
妥	gentle
乳	milk
浮	floating
将	leader
奨	exhort
採	pick (kanji used for picking fruits from trees)
菜	vegetable
受	accept
授	impart
愛	love
払	pay
広	wide
拡	broaden
鉱	mineral
弁	valve ［elbow...two hands］
雄	masculine
台	pedestal
怠	neglect
治	reign
始	commence
胎	womb
窓	window
去	gone
法	method
会	meeting
至	climax (to peak, to arrive at end etc)
室	room (-room)
到	arrival
致	doth
互	mutually
棄	abandon
育	bring up
撤	remove
充	allot
銃	gun
硫	sulfur
流	current
允	license
唆	tempt
出	exit
山	mountain
拙	bungling
岩	boulder
炭	charcoal
岐	branch off
峠	mountain peak
崩	crumble
密	secrecy
蜜	honey
嵐	storm
崎	promonotory
入	enter (+*go-/put-/come in, 八 when at top)
込	crowded
分	part
貧	poverty
頒	partition
公	public
松	pine tree
翁	venerable old man
訟	sue
谷	valley
浴	bathe
容	contain
溶	melt
欲	longing
裕	abundant
鉛	lead (metal)
沿	run alongside [water...gully]
賞	prize
党	party
堂	public chamber
常	usual
裳	skirt
掌	manipulate
皮	pelt
波	waves
婆	old woman
披	expose
破	rend
被	incur
残	remainder
殉	martyrdom
殊	particularly
殖	augment
列	file (people or things lined up in a row)
裂	split
烈	ardent
死	death
葬	interment
瞬	wink
耳	ear
取	take
趣	gist
最	utmost
撮	snapshot
恥	shame
職	post (one's occupation) [ear...kazoo]
聖	holy
敢	daring
聴	listen
懐	pocket
慢	ridicule
漫	loose (cartoon)
買	buy
置	placement
罰	penalty
寧	rather
濁	voiced
環	ring
還	send back
夫	husband
扶	aid
渓	mountain stream
規	standard
替	exchange
賛	approve
潜	submerge
失	lose (+*drop)
鉄	iron
迭	alternate
臣	retainer (*slave)
姫	princess
蔵	storehouse
臓	entrails
賢	intelligent
堅	strict
臨	look to
覧	perusal
巨	gigantic
拒	repel
力	power (*muscle/power)
男	male
労	labor
募	recruit
劣	inferiority
功	achievement
勧	persuade
努	toil
励	encourage
加	add
賀	congratulations
架	erect
脇	armpit
脅	threaten
協	co-
行	going
律	rhythm
復	restore [going...double back (retrace one's course)]
得	gain
従	accompany
徒	junior
待	wait
往	journey
征	subjugate
径	diameter
彼	he
役	duty
徳	benevolence
徹	penetrate
徴	indications
懲	penal
微	delicate
街	boulevard
衡	equilibrium
稿	draft
稼	earnings
程	extent
税	tax
稚	immature
和	harmony
移	shift
秒	second
秋	autumn
愁	distress
私	private
秩	regularity
秘	secret
称	appelation
利	profit
梨	pear tree
穫	harvest
穂	ear of a plant
稲	rice plant
香	incense
季	seasons
委	committe
秀	excel
透	transparent
誘	entice
穀	cereals
菌	germ
米	rice (+*united states)
粉	flour
粘	sticky
粒	grains
粧	cosmetics
迷	astray
粋	chic (style)
糧	provisions
菊	chrysanthemum
奥	core
数	number
楼	watchtower
類	sort
漆	lacquer
様	Esq (sama)
求	request
球	ball
救	salvation
竹	bamboo
笑	laugh
笠	bamboo hat
笹	bamboo grass
筋	muscle
箱	box
筆	writing brush
筒	cylinder
等	etc.
算	calculate
答	solution
策	scheme
簿	register
築	fabricate
人	person
佐	assistant
但	however
住	dwell
位	rank
仲	go-between
体	body
悠	remote
件	affair
仕	attend (*to wait on someone or serve them)
他	other
伏	prostrated
伝	transmit
仏	Budha
休	rest
仮	provisional
伯	chief
俗	vulgar
信	faith
佳	excellent
依	reliant
例	example
個	individual
健	healthy
側	side
侍	waiter
停	halt
値	price
倣	emulate
倒	overthrow
偵	spy
僧	Buddhist priest
億	hundred million
儀	ceremony
償	reparation
仙	hermit
催	sponsor
仁	humanity
侮	scorn
使	use 
便	convenience
倍	double
優	tenderness
伐	fell
宿	inn
傷	wound
保	protect
褒	praise
傑	greatness
付	adhere
符	token
府	municipality
任	responisibility　[person...porter]
賃	fare
代	substitute
袋	sack
貸	lend
化	change
花	flower
貨	freight
傾	lean (on or towards something)
何	what
荷	baggage
俊	sagacious
傍	bystander
久	long-time
畝	furrow
囚	captured
内	inside
丙	third class
柄	design
肉	meat
腐	rot
座	sit
卒	graduate
傘	umbrella
匁	monme
以	by means of
似	similar
併	join
瓦	tile
瓶	flower pot
宮	Shinto shrine
営	occupation
善	virtuous
年	year
夜	night
液	fluid
塚	hillock
幣	cash
弊	abuse
喚	yell
換	interchange
融	dissolve
施	alms
旋	rotation
遊	play
旅	trip
勿	not (*knot)
物	thing
易	easy
賜	grant
尿	urine
尼	nun
泥	mud
塀	fence
履	footgear
屋	roof
握	grip
屈	yield
掘	dig
堀	ditch
居	reside
据	set
層	stratum
局	bureau
遅	slow
漏	leak
刷	printing
尺	shaku (*shakuhachi flute)
尽	exhaust
沢	swamp
訳	translate
択	choose
昼	daytime
戸	door
肩	shoulder
房	tassel
扇	fan
炉	hearth
戻	re-
涙	tears
雇	employ
顧	look back
啓	disclose
示	show (*altar, at left ->礼)
礼	salutation
祥	auspicious
祝	celebrate
福	blessing
祉	welfare
社	company
視	inspection
奈	Nara
尉	military officer
慰	consolation
款	goodwill
禁	prohobition
襟	collar
宗	religion　
崇	adore
祭	ritual
察	guess
擦	grate
由	wherefore (*shoot/sprout)
抽	pluck
油	oil
袖	sleeve
宙	mid-air
届	deliver
笛	flute
軸	axis
甲	armor (*roots)
押	push
岬	headland
挿	insert
申	speaketh (*monkey)
伸	expand
神	gods
捜	search
果	fruit
菓	candy
課	chapter
裸	naked
斤	ax
析	chop
所	place
祈	pray
近	near
折	fold
哲	philosophy
逝	departed
誓	vow [fold...words]
暫	temporarily
漸	steadily
断	severance
質	substance
斥	reject
訴	accusation
昨	yesterday
詐	lie
作	make
雪	snow
録	record
尋	inquire
急	hurry
穏	calm
侵	encroach
浸	immersed
寝	lie down
婦	lady
掃	sweep
当	hit ［little...broom］
争	contend
浄	clean
事	matter
唐	T'ang (Dynasty in china)
糖	sugar
康	sane
逮	apprehend
伊	Italy
君	old boy
群	flock
耐	-proof (i.e rustproof etc)
需	demand
儒	Confucian
端	edge
両	both
満	full
画	brush-stroke
歯	tooth
曲	bend
曹	cadet
遭	encounter
漕	rowing
槽	vat (tub, tank)
斗	Big Dipper (*measuring cup)
料	fee
科	department
図	map
用	utilize (*screwdriver)
庸	commonplace/ordinary
備	equip
昔	once upon a time
錯	confused
借	borrow
惜	pity
措	set aside
散	scatter
廿	twenty
庶	commoner
遮	intercept
席	seat
度	degrees
渡	transit
奔	bustle
噴	erupt
墳	tomb
憤	aroused
焼	bake
暁	daybreak
半	half
伴	consort
畔	paddy ridge
判	judgement
券	ticket
巻	scroll
圏	sphere
勝	victory
藤	wisteria
謄	facsimilie (mimeograph/copy)
片	one-sided (one part of the whole)
版	printing block
之	of (*building blocks with hiragana written on them)
乏	destitution
芝	turf
不	negative
否	negate
杯	cupfuls
矢	dart
矯	rectify
族	tribe
知	know
智	wisdom
矛	halberd
柔	tender
務	task
霧	fog
班	squad
帰	homecoming
弓	bow
引	pull
弔	condolences
弘	vast
強	strong
弱	weak
沸	seethe
費	expense
第	No.
弟	younger brother
巧	adroit
号	nickname
朽	decay
誇	boast
汚	dirty
与	bestow
写	copy
身	somebody
射	shoot
謝	apologize
老	old man
考	consider
孝	filial piety
教	teach　
拷	torture
者	someone (*puppet-on-a-string)
煮	boil
著	renowned
署	signature
暑	sultry
諸	various
猪	boar
渚	strand (beach/shoreline)
賭	gamble
峡	gorge
狭	cramped
挟	sandwiched
追	chase
師	expert
帥	commander
官	bureaucrat
棺	coffin
管	pipe
父	father
交	mingle
効	merit
較	contrast
校	exam 
足	leg
促	stimulate
距	long-distance
路	path	
露	dew
跳	hop
躍	leap
践	tread
踏	step
骨	skeleton
滑	slippery
髄	marrow
禍	calamity
渦	whirlpool
過	overdo
阪	Heights
阿	africa
際	occasion
障	hinder
随	follow
陪	auxiliary
陽	sunshine
陳	line up
防	ward off
附	affixed
院	Inst. (institution)
陣	camp
隊	regiment
墜	crash
降	descend
階	storey (story)
陛	highness
隣	neighboring
隔	isolate
隠	conceal
堕	degenerate
陥	collapse
穴	hole (*eight replaced with human legs)
空	empty
控	withdraw
突	stab
究	research
窒	plug up
窃	stealth
窪	depression
搾	squeeze
窯	kiln
窮	hard up
探	grope
深	deep
丘	hill
岳	Point
兵	soldier
浜	seacoast
糸	thread
織	weave
繕	darning
縮	shrink
繁	luxuriant
縦	vertical
線	line
締	tighten
維	fiber
羅	gauze
練	practise
緒	thong
続	continue
絵	picture
統	overall
絞	strangle
給	salary
絡	entwine
結	tie
終	end
級	class
紀	chronicle
紅	crimson
納	settlement
紡	spinning (of thread and other fibers)
紛	distract
紹	introduce
経	sutra (line, rule, formula, scriptures)
紳	sire (gentleman)
約	promise
細	dainty
累	accumulate
索	cord
総	general
綿	cotton
絹	silk
繰	winding
継	inherit
緑	green
縁	affinity
網	netting
緊	tense
紫	purple
縛	truss
縄	straw rope
幼	infancy
後	behind
幽	faint
幾	how many (*abacus)
機	mechanism
玄	mysterious
畜	livestock
蓄	amass
弦	bowstring
擁	hug
滋	nourishing (närande)
慈	mercy
磁	magnet
系	lineage (*yarn)
係	person in charge
孫	grandchild
懸	suspend
却	instead
脚	shins
卸	wholesale
御	honorable
服	clothing
命	fate
令	orders
零	zero
齢	age
冷	cool
領	jurisdiction　
鈴	small bell
勇	courage
通	traffic
踊	jump
疑	doubt
擬	mimic
凝	congeal
範	pattern
犯	crime
厄	unlucky
危	dangerous
宛	address
腕	arm
苑	garden
怨	grudge
柳	willow
卵	egg
留	detain
貿	trade
印	stamp
興	entertain
酉	sign of the bird (*whisky bottle/long necked bird)
酒	sake
酌	bartending
酵	fermentation
酷	cruel
酬	repay
酪	dairy products
酢	vinegar
酔	drunk
配	distribute
酸	acid
猶	waver, furthermore
尊	revered
豆	beans (*table)
頭	head
短	short
豊	bountiful
鼓	drum
喜	rejoice
樹	timber-trees
皿	dish
血	blood
盆	basin
盟	alliance
盗	steal
温	warm
監	oversee
濫	overflow
鑑	specimen
猛	fierce
盛	boom
塩	salt
銀	silver
恨	resentment
根	root
即	instant
爵	baron
節	node
退	retreat
限	limit
眼	eyeball
良	good (*saint's halo)
朗	melodius
浪	wandering
娘	daughter
食	eat (*eating/food)
飯	meal
飲	drink
飢	hungry
餓	starve
飾	decorate
館	Bldg. (building) 
養	foster
飽	sated
既	previously
概	outline
慨	rue
平	even (*water lily)
呼	call
坪	two-mat area (36 square feets, or about 2 tatami mats)
評	evaluate
刈	reap (skära)
希	hope
凶	villain
胸	bosom
離	detach
殺	kill
純	genuine
鈍	dull
辛	spicy
辞	resign
梓	catalpa
宰	superintend
壁	wall